11111111111111
10000010000001
1P0001C1000001
11000000000001
110001E1000001
11111111111111